###################
###GGGLLDDDODRRRRR#
#RRRRGLDDDDDGGGG###
##GGGGGGDDD##DDDD##
#########DSDDDRRDG#
#RRRRDDDDDRGLLLDDL#
#LLLLDRRR######DDD#
#RRRLDLGGGGDDDDD###
#GLGRDDRLDDDGLRDDL#
######DDDDLLLRRRD##
###################