###################
###GGGLLDDDODRRRRR#
#RRRRGLDDDDDGGGG###
##GGGGGGDDD##DDDD##
#########DS#DDRRDG#
#RRRRDDDD#RGLLLDDL#
#LLLLDRRR######DDD#
#RRRLDLGGGGDDDDD###
#GLGRDDRLDDDGLRDDL#
######DDDDLLLRRRD##
###################