#######################
###GGGLLDDDDDRRRRRDDDR#
#RRRRGLDDDDDGGGG###DDD#
##GGGGGGDDD##DDDD##DRR#
#########DSDDDRRDG#D###
#RRRRDDDDDRGLLLDDDDLLL#
#LLLLDRRR######DDD###G#
#RRRLDLGGGGDDDDD#######
#GLGRDDRLDDDGLRDDLDDDD#
######DDDDLLLRRRD####D#
###########DD#######DD#
#RGLRGLRGRLGGGGSDDDDDD#
#DDDDDDDDDDDDDDD####GG#
#DDDDDDDDDLLLLLGGGG####
#######################